20|8
####################
#@..............B..#
#...####...........#
#...#..............#
#...#...E..........#
#...####N..........#
#.................$#
####################
