20|8
####################
#@..............B..#
#...####...........#
#...#..............#
#..................#
#...####N..........#
#..................#
####################
