20|8
####################
#@..........#......#
#.##..####..#......#
#..#.......##......#
#..#.......#.......#
#..####....#.......#
#..................#
####################