20|8
####################
#@..................#
#...####...........#
#...#..............#
#...#..............#
#...####...........#
#...................#
####################